10
10
2121212121
1030203002
2000000001
1000000002
2000000001
1000000002
2000010001
1000000002
2003020301
1212121212
